TILEMAP
32 22 							-- Size of tile map in tiles
16 16 							-- Tile size & block size
images/nuevo_tileset.png 				-- Tilesheet
10 10 							-- Number of tiles in tilesheet
0 0 0 0 0 0 0 0 0 0 0 0 0 0 0 0 0 0 0 0 0 0 0 0 0 0 0 0 0 0 0 0
0 0 -1 -1 -1 -1 -1 -1 -1 -1 -1 -1 -1 -1 -1 -1 -1 -1 -1 -1 -1 -1 -1 -1 -1 -1 -1 -1 -1 -1 0 0
0 0 -1 -1 -1 -1 -1 -1 -1 -1 -1 -1 -1 -1 -1 -1 -1 -1 -1 -1 -1 -1 -1 -1 -1 -1 -1 -1 -1 -1 0 0
0 0 -1 -1 -1 -1 -1 -1 -1 -1 -1 -1 -1 -1 -1 -1 -1 -1 -1 -1 -1 -1 -1 -1 -1 -1 -1 -1 -1 -1 0 0
0 0 -1 -1 -1 -1 -1 -1 -1 -1 -1 -1 -1 -1 -1 -1 -1 -1 -1 -1 -1 -1 -1 -1 -1 -1 -1 -1 -1 -1 0 0
0 0 -1 -1 -1 -1 20 21 21 21 21 21 21 21 21 21 21 21 21 21 21 21 21 21 21 22 -1 -1 -1 -1 0 0
0 0 -1 -1 -1 -1 -1 -1 -1 -1 -1 -1 -1 -1 23 24 36 37 -1 -1 -1 -1 -1 -1 -1 -1 -1 -1 -1 -1 0 0
0 0 -1 -1 -1 -1 -1 -1 -1 -1 -1 -1 -1 -1 25 26 34 35 -1 -1 -1 -1 -1 -1 -1 -1 -1 -1 -1 -1 0 0
0 0 -1 -1 -1 43 -1 -1 -1 -1 20 21 21 22 23 24 36 37 20 21 21 22 -1 -1 -1 -1 43 -1 -1 -1 0 0
0 0 -1 -1 -1 -1 -1 -1 -1 -1 -1 -1 -1 -1 25 26 34 35 -1 -1 -1 -1 -1 -1 -1 -1 -1 -1 -1 -1 0 0
0 0 -1 -1 -1 -1 -1 -1 -1 -1 -1 -1 -1 -1 23 24 36 37 -1 -1 -1 -1 -1 -1 -1 -1 -1 -1 -1 -1 0 0
0 0 20 21 21 22 -1 -1 20 21 21 21 21 22 25 26 34 35 20 21 21 21 21 22 -1 -1 20 21 21 22 0 0
0 0 -1 -1 23 37 -1 -1 23 37 -1 -1 -1 -1 -1 -1 -1 -1 -1 -1 -1 -1 23 37 -1 -1 23 37 -1 -1 0 0
0 0 -1 -1 25 35 -1 -1 25 35 -1 -1 -1 -1 -1 -1 -1 -1 -1 -1 -1 -1 25 35 -1 -1 25 35 -1 -1 0 0
0 0 -1 -1 74 74 -1 -1 74 74 20 21 21 21 21 21 21 21 21 21 21 22 74 74 -1 -1 74 74 -1 -1 0 0
0 0 -1 -1 -1 -1 -1 -1 -1 -1 -1 -1 -1 -1 23 24 36 37 -1 -1 -1 -1 -1 -1 -1 -1 -1 -1 -1 -1 0 0
0 0 -1 -1 -1 -1 -1 -1 -1 -1 -1 -1 -1 -1 25 26 34 35 -1 -1 -1 -1 -1 -1 -1 -1 -1 -1 -1 -1 0 0
0 0 -1 -1 -1 42 -1 -1 -1 -1 20 21 21 22 23 24 36 37 20 21 21 22 -1 -1 -1 -1 42 -1 -1 -1 0 0
0 0 -1 -1 -1 -1 -1 -1 -1 -1 -1 -1 -1 -1 25 26 34 35 -1 -1 -1 -1 -1 -1 -1 -1 -1 -1 -1 -1 0 0
0 0 -1 -1 -1 -1 -1 -1 -1 -1 -1 -1 -1 -1 23 24 36 37 -1 -1 -1 -1 -1 -1 -1 -1 -1 -1 -1 -1 0 0
0 0 20 21 21 21 21 21 21 21 21 21 21 22 25 26 34 35 20 21 21 21 21 21 21 21 21 21 21 22 0 0
0 0 0 0 0 0 0 0 0 0 0 0 0 0 0 0 0 0 0 0 0 0 0 0 0 0 0 0 0 0 0 0
