TILEMAP
32 22 							-- Size of tile map in tiles
16 16 							-- Tile size & block size
images/tileset.png 					-- Tilesheet
38 16 							-- Number of tiles in tilesheet
250 250 250 250 250 250 250 250 250 250 250 250 250 250 250 250 250 250 250 250 250 250 250 250 250 250 250 250 250 250 250 250
250 250 -1 -1 -1 -1 -1 -1 -1 -1 -1 -1 -1 -1 -1 -1 -1 -1 -1 -1 -1 -1 -1 -1 -1 -1 -1 -1 -1 -1 250 250
250 250 -1 -1 -1 -1 -1 -1 -1 -1 -1 -1 -1 -1 -1 -1 -1 -1 -1 -1 -1 -1 -1 -1 -1 -1 -1 -1 -1 -1 250 250
250 250 -1 -1 -1 -1 -1 -1 -1 -1 -1 -1 -1 -1 -1 -1 -1 -1 -1 -1 -1 -1 -1 -1 -1 -1 -1 -1 -1 -1 250 250
250 250 -1 -1 -1 -1 -1 -1 -1 -1 -1 -1 -1 -1 -1 -1 -1 -1 -1 -1 -1 -1 -1 -1 -1 -1 -1 -1 -1 -1 250 250
250 250 -1 -1 -1 -1 -1 -1 138 138 138 138 138 138 138 138 138 138 138 138 138 138 138 138 -1 -1 -1 -1 -1 -1 250 250
250 250 -1 -1 271 -1 -1 -1 -1 -1 -1 -1 -1 -1 250 250 250 250 -1 -1 -1 -1 -1 -1 -1 -1 -1 271 -1 -1 250 250
250 250 -1 -1 -1 -1 -1 -1 -1 -1 -1 -1 -1 -1 250 250 250 250 -1 -1 -1 -1 -1 -1 -1 -1 -1 -1 -1 -1 250 250
250 250 -1 -1 -1 -1 138 138 138 138 138 138 138 138 250 250 250 250 138 138 138 138 138 138 138 138 -1 -1 -1 -1 250 250
250 250 -1 -1 -1 -1 -1 -1 -1 -1 -1 -1 -1 -1 250 250 250 250 -1 -1 -1 -1 -1 -1 -1 -1 -1 -1 -1 -1 250 250
250 250 -1 -1 -1 -1 -1 -1 -1 -1 -1 -1 -1 -1 250 250 250 250 -1 -1 -1 -1 -1 -1 -1 -1 -1 -1 -1 -1 250 250
250 250 -1 -1 138 138 138 138 138 138 138 138 138 138 250 250 250 250 138 138 138 138 138 138 138 138 138 138 -1 -1 250 250
250 250 -1 -1 -1 -1 -1 -1 -1 -1 208 -1 -1 -1 -1 -1 -1 -1 89 -1 -1 -1 -1 -1 -1 -1 -1 -1 -1 -1 250 250
250 250 -1 -1 -1 -1 -1 -1 -1 -1 246 -1 -1 -1 -1 -1 -1 -1 127 -1 -1 -1 -1 -1 -1 -1 -1 -1 -1 -1 250 250
250 250 -1 -1 138 138 138 138 -1 -1 284 -1 -1 -1 267 268 269 -1 165 -1 -1 -1 -1 -1 138 138 138 138 -1 -1 250 250
250 250 -1 -1 208 -1 -1 -1 -1 -1 246 -1 -1 -1 305 306 307 -1 203 -1 -1 -1 -1 -1 -1 -1 -1 208 -1 -1 250 250
250 250 -1 -1 360 -1 -1 -1 -1 -1 284 -1 -1 -1 343 344 345 -1 -1 -1 -1 -1 -1 -1 -1 -1 -1 360 -1 -1 250 250
250 250 -1 -1 138 138 -1 -1 -1 -1 284 -1 -1 -1 -1 -1 -1 -1 -1 -1 -1 324 -1 -1 -1 -1 138 138 -1 -1 250 250
250 250 -1 -1 -1 208 -1 -1 -1 -1 322 -1 -1 -1 -1 -1 -1 -1 -1 -1 -1 322 -1 -1 -1 -1 208 -1 -1 -1 250 250
250 250 -1 -1 -1 360 -1 -1 -1 -1 360 -1 -1 -1 -1 -1 -1 -1 -1 -1 -1 362 -1 -1 -1 -1 360 -1 -1 -1 250 250
250 250 138 138 138 138 138 138 138 138 138 138 -1 -1 -1 -1 -1 -1 -1 -1 138 138 138 138 138 138 138 138 138 138 250 250
288 288 288 288 288 288 288 288 288 288 288 288 387 387 387 387 387 387 387 387 288 288 288 288 288 288 288 288 288 288 288 288
163 164 163 164 163 164 163 164 163 164 163 164 163 164 163 164 163 164 163 164 163 164 163 164 163 164 163 164 163 164 163 164
201 202 201 202 201 202 201 202 201 202 201 202 201 202 201 202 201 202 201 202 201 202 201 202 201 202 201 202 201 202 201 202
163 164 163 164 163 164 163 164 163 164 163 164 163 164 163 164 163 164 163 164 163 164 163 164 163 164 163 164 163 164 163 164
201 202 201 202 201 202 201 202 201 202 201 202 201 202 201 202 201 202 201 202 201 202 201 202 201 202 201 202 201 202 201 202
163 164 163 164 163 164 163 164 163 164 163 164 163 164 163 164 163 164 163 164 163 164 163 164 163 164 163 164 163 164 163 164
201 202 201 202 201 202 201 202 201 202 201 202 201 202 201 202 201 202 201 202 201 202 201 202 201 202 201 202 201 202 201 202
163 164 163 164 163 164 163 164 163 164 163 164 163 164 163 164 163 164 163 164 163 164 163 164 163 164 163 164 163 164 163 164
201 202 201 202 201 202 201 202 201 202 201 202 201 202 201 202 201 202 201 202 201 202 201 202 201 202 201 202 201 202 201 202
163 164 163 164 163 164 163 164 163 164 163 164 163 164 163 164 163 164 163 164 163 164 163 164 163 164 163 164 163 164 163 164
201 202 201 202 201 202 201 202 201 202 201 202 201 202 201 202 201 202 201 202 201 202 201 202 201 202 201 202 201 202 201 202
163 164 163 164 163 164 163 164 163 164 163 164 163 164 163 164 163 164 163 164 163 164 163 164 163 164 163 164 163 164 163 164
201 202 201 202 201 202 201 202 201 202 201 202 201 202 201 202 201 202 201 202 201 202 201 202 201 202 201 202 201 202 201 202
163 164 163 164 163 164 163 164 163 164 163 164 163 164 163 164 163 164 163 164 163 164 163 164 163 164 163 164 163 164 163 164
201 202 201 202 201 202 201 202 201 202 201 202 201 202 201 202 201 202 201 202 201 202 201 202 201 202 201 202 201 202 201 202
163 164 163 164 163 164 163 164 163 164 163 164 163 164 163 164 163 164 163 164 163 164 163 164 163 164 163 164 163 164 163 164
201 202 201 202 201 202 201 202 201 202 201 202 201 202 201 202 201 202 201 202 201 202 201 202 201 202 201 202 201 202 201 202
163 164 163 164 163 164 163 164 163 164 163 164 163 164 163 164 163 164 163 164 163 164 163 164 163 164 163 164 163 164 163 164
201 202 201 202 201 202 201 202 201 202 201 202 201 202 201 202 201 202 201 202 201 202 201 202 201 202 201 202 201 202 201 202
163 164 163 164 163 164 163 164 163 164 163 164 163 164 163 164 163 164 163 164 163 164 163 164 163 164 163 164 163 164 163 164
201 202 201 202 201 202 201 202 201 202 201 202 201 202 201 202 201 202 201 202 201 202 201 202 201 202 201 202 201 202 201 202
163 164 163 164 163 164 163 164 163 164 163 164 163 164 163 164 163 164 163 164 163 164 163 164 163 164 163 164 163 164 163 164
201 202 201 202 201 202 201 202 201 202 201 202 201 202 201 202 201 202 201 202 201 202 201 202 201 202 201 202 201 202 201 202
